#########
#X     X#
#   P   #
#   X   #
#   O   #
#X     X#
#########