#########
#   O   #
#   P   #
#   X   #
#       #
#       #
#########