#########
#   O   #
#       #
#   XP  #
#       #
#       #
#########