#########
#   O   #
#       #
#  PX   #
#       #
#       #
#########