#########
#       #
#   O   #
#   X   #
#   P   #
#       #
#########