#########
#   O   #
#       #
#   X   #
#   P   #
#       #
#########