#########
#       #
#       #
#  PXO  #
#       #
#       #
#########