#########
#       #
#       #
#  OXP  #
#       #
#       #
#########