#########
#       #
#   P   #
#   X   #
#   O   #
#       #
#########